{
    "latin": [
        {
            "a": "\u2801",
            "b": "\u2803",
            "c": "\u2809",
            "d": "\u2819",
            "e": "\u2811",
            "f": "\u280B",
            "g": "\u281B",
            "h": "\u2813",
            "i": "\u280A",
            "j": "\u281A"
        },
        {
            "k": "\u2805",
            "l": "\u2807",
            "m": "\u280D",
            "n": "\u281D",
            "o": "\u2815",
            "p": "\u280F",
            "q": "\u281F",
            "r": "\u2817",
            "s": "\u280E",
            "t": "\u281E"
        },
        {
            "u": "\u2825",
            "v": "\u2827",
            "w": "\u283A",
            "x": "\u282D",
            "y": "\u283D",
            "z": "\u2835"
        },
        {
            ",": "\u2802",
            ";": "\u2806",
            "'": "\u2804",
            ":": "\u2812",
            "-": "\u2824",
            ".": "\u2832",
            "!": "\u2816",
            "?": "\u2826",
            "\"": "\u2834",
            "(": "\u2836",
            ")": "\u2836",
            "/": "\u280C"
        },
        {
            "ch": "\u2821",
            "sh": "\u2829",
            "th": "\u2839",
            "and": "\u282F"
        }
    ]
}
